R 520 400
WE ./textures/GrayWalls.xpm
NO ./textures/GrayWalls.xpm
SO ./textures/GrayWalls.xpm
EA ./textures/GrayWalls.xpm
S ./textures/GrayWalls.xpm

F 255,10,0
C 0,200,250

        1111111111111111111111111111
        1000000000110000000000001001
        1101100000111000000200000111
        1001000000000000W000000011
111111111011000001110000000000001
100000000011000001110111111111111
11110111111111011100000010001
11110111111111011101010010001
11000000110101011100000100011  
10002000000000000000000000001
10000000000000001101010010001
1100000111010101111101111000111
11110111 1110101 101111010001
11111111 1111111 111111111111
