R  420 300
WE ./textures/bluestone.xpm
NO ./textures/greystone.xpm
SO ./textures/wood.xpm
EA ./textures/redbrick.xpm
S ./textures/barrel.xpm

F 30,0,0
C 0,200,250

1111111111111111111
1000000000000000001
1000002000000000W01
1000000001000000001
1020002002200000001
1000000002000000001
1000000000000000001
1000000000000000001
1111111111111111111
