R	111111 1111111

NO	./textures/GrayWalls.xpm
SO	./textures/GrayWalls.xpm
WE	./textures/GrayWalls.xpm
EA	./textures/GrayWalls.xpm
S	./textures/GrayWalls.xpm

F	68, 68,  68
C	51, 204, 255

11111111111111111   11111
10000000000000001   10001
10000000000000001   10001
1000000000000000111110001
1000000000000000000000N01
1000000000000000000000001
1000000000000000000000001
1000000000000000000000001
1000000000000000000000001
1000000000000000000000001
1000000000000000000000001
1000000000000000000000001
1000000000000000000000001
1000000000000000000000001
1000000000000000000000001
1000000000000000000000001
1000000000000000000000001
1000000000000000000000001
1000000000000000000000001
11111000000000000000000011111
    1000000000000000000000001
11111000000000000000000011111
1000000000000000000000001
1000000000000000000000001
1111111111111111111111111
